........................
.....@..................
..########..............
.........#..../.........
..####...#......../.....
..#....##...............
..#..................... 
..#.....................