............
............
..####......
..#...#.....
..####......
..#.........
..#.....@...
..#.........